######
#....####
#....#..#
#.......#
####.#..#
 #...#..#   
 #...####
 #...#
 #####